Đe thoat \q or exit() or logout 
sudo apt-get update

sudo apt-get install postgresql postgresql-contrib

service postgresql

service postgresql status

(iteslateq-platform) root@iteslateq:/app# sudo su postgres

postgres@iteslateq:~$ psql

postgres=# ALTER USER postgres WITH PASSWORD 'teslateq';
ALTER ROLE

postgres=# CREATE USER teslateq WITH PASSWORD 'teslateq';
CREATE ROLE

postgres=# ALTER USER teslateq WITH SUPERUSER ;

postgres=# \du

postgres=# \l

postgres@ubuntu:~$ createdb --owner db_user django_db
postgres@ubuntu:~$ logout

postgres-# ^Z
[1]+  Stopped                 psql
postgres@iteslateq:~$ loguot
bash: loguot: command not found
postgres@iteslateq:~$ logout
bash: logout: not login shell: use `exit'
postgres@iteslateq:~$ exit
exit
(iteslateq-platform) root@iteslateq:/app/iteslateq-platform# 



postgres@iteslateq:/app/iteslateq-platform$ createuser --interactive -P
perl: warning: Setting locale failed.
perl: warning: Please check that your locale settings:
	LANGUAGE = (unset),
	LC_ALL = (unset),
	LC_PAPER = "vi_VN",
	LC_ADDRESS = "vi_VN",
	LC_MONETARY = "vi_VN",
	LC_NUMERIC = "vi_VN",
	LC_TELEPHONE = "vi_VN",
	LC_IDENTIFICATION = "vi_VN",
	LC_MEASUREMENT = "vi_VN",
	LC_TIME = "vi_VN",
	LC_NAME = "vi_VN",
	LANG = "en_US.UTF-8"
    are supported and installed on your system.
perl: warning: Falling back to a fallback locale ("en_US.UTF-8").
Enter name of role to add: iteslateq
Enter password for new role: 
Enter it again: 
Shall the new role be a superuser? (y/n) n
Shall the new role be allowed to create databases? (y/n) n
Shall the new role be allowed to create more new roles? (y/n) n
postgres@iteslateq:/app/iteslateq-platform$ createdb --owner iteslateq iteslateq
perl: warning: Setting locale failed.
perl: warning: Please check that your locale settings:
	LANGUAGE = (unset),
	LC_ALL = (unset),
	LC_PAPER = "vi_VN",
	LC_ADDRESS = "vi_VN",
	LC_MONETARY = "vi_VN",
	LC_NUMERIC = "vi_VN",
	LC_TELEPHONE = "vi_VN",
	LC_IDENTIFICATION = "vi_VN",
	LC_MEASUREMENT = "vi_VN",
	LC_TIME = "vi_VN",
	LC_NAME = "vi_VN",
	LANG = "en_US.UTF-8"
    are supported and installed on your system.
perl: warning: Falling back to a fallback locale ("en_US.UTF-8").
postgres@iteslateq:/app/iteslateq-platform$ psql
perl: warning: Setting locale failed.
perl: warning: Please check that your locale settings:
	LANGUAGE = (unset),
	LC_ALL = (unset),
	LC_PAPER = "vi_VN",
	LC_ADDRESS = "vi_VN",
	LC_MONETARY = "vi_VN",
	LC_NUMERIC = "vi_VN",
	LC_TELEPHONE = "vi_VN",
	LC_IDENTIFICATION = "vi_VN",
	LC_MEASUREMENT = "vi_VN",
	LC_TIME = "vi_VN",
	LC_NAME = "vi_VN",
	LANG = "en_US.UTF-8"
    are supported and installed on your system.
perl: warning: Falling back to a fallback locale ("en_US.UTF-8").
psql (9.5.14)
Type "help" for help.

postgres=# \du
                                   List of roles
 Role name |                         Attributes                         | Member of 
-----------+------------------------------------------------------------+-----------
 iteslateq |                                                            | {}
 platform  | Superuser                                                  | {}
 postgres  | Superuser, Create role, Create DB, Replication, Bypass RLS | {}

postgres=# \l
                                  List of databases
   Name    |   Owner   | Encoding |   Collate   |    Ctype    |   Access privileges   
-----------+-----------+----------+-------------+-------------+-----------------------
 iteslateq | iteslateq | UTF8     | en_US.UTF-8 | en_US.UTF-8 | 
 platform  | postgres  | UTF8     | en_US.UTF-8 | en_US.UTF-8 | 
 postgres  | postgres  | UTF8     | en_US.UTF-8 | en_US.UTF-8 | 
 template0 | postgres  | UTF8     | en_US.UTF-8 | en_US.UTF-8 | =c/postgres          +
           |           |          |             |             | postgres=CTc/postgres
 template1 | postgres  | UTF8     | en_US.UTF-8 | en_US.UTF-8 | =c/postgres          +
           |           |          |             |             | postgres=CTc/postgres
(5 rows)

postgres=# ALTER USER teslateq WITH SUPERUSER ;
ERROR:  role "teslateq" does not exist
postgres=# ALTER USER iteslateq WITH SUPERUSER ;
ALTER ROLE
postgres=# \du
                                   List of roles
 Role name |                         Attributes                         | Member of 
-----------+------------------------------------------------------------+-----------
 iteslateq | Superuser                                                  | {}
 platform  | Superuser                                                  | {}
 postgres  | Superuser, Create role, Create DB, Replication, Bypass RLS | {}

postgres=# ^Z
[3]+  Stopped                 psql
postgres@iteslateq:/app/iteslateq-platform$ 

postgres=# DROP DATABASE [IF EXISTS] name;

